####################################################################################################
#      #   #       #      #    #           #    ###            #      #       #    #      ##  # # ##
# ## #  ##   ## ## # ## ##  ##  # # # ### #  ##  #  ### ## ## #  ## #  # # ## # #### # ##    #     #
#   #  #   ##     ##  # ## # ##  #   #  #   #  #   #  # # #    ##   # #  # #    #    #   ## #  # # #
# #  ##  ##  # # #   ##    #   # # #   #  ## # # ### ##    ###    ##   ##  # # ## # # ## #   #  #  #
# ##  # #  # #  #  ##  # ### # # #  # #  #      #      ###    ## # # ##   #   #    #   #  # #  ## ##
#  ##   ##    # # #   # #   #  # ##  #  #  ## #   # # #   ###   #  #    ##  # # # ## #  #  #  #    #
##   ### ## ##  #  # #    #   ##   ##  # #   #  ###  #  #    ##  #  #### # ###  ##   # #  #  #  # ##
### #  #     # #  ##   ### ## # ## #  #   ##  ##   # ## # ##  ## # ##      ### #   # # # #  #  #   #
###  #   # ##  # #   ##    #    #   #   #   #    #E#    # #  #   #    ####  #  # ## #  #   #  # # ##
## #  # #  ## #  # # #####  # #  ## ## # ## #######  ###  # #  ##  ###    ### ##  #  # # ##  ## #  #
#   # # # #   # #  #  #   # # ##  #   #   #      #  #    ## ## ## #    ## #   # # ## # #  # #    # #
# ###  #  # # #   #  ## # #    # #### # # #### # # ### ##    #   #  # # #   ##  #  #    # # # ###  #
#     #  #  #  ###  #   # # ###   #   # #    # #  # #  #  ##  ##   #     ###  # ## # ## ##  #    # #
# # ## #  #  ##    ## ##  ##   #### ##  ## #  #  #   # # #  ### # # ### #    #   # ##      #####   #
# ##     ###   # ##   #  #   #      #  # #  ##  ## # # # # #     ##   #  # #   # #   ### #  #   # ##
#    ###  ####   #  ### #  # # ## ##  #   #    #   #   #   # ### #  #  # ##  ##   ##    #  ## # # ##
## ##   #  #  ### # #    # #  #  # # #  #  ###   ## ##  # #  # #   #  ##   # #  #   ### # #   # #  #
# # # #  #  # #   #  # #  ### ##       #  #   # # #    # ## #   ###  #  ##  #  # ## #   # # # #  # #
#    #  # #     ## # ####  ##  # # ####  #  #  ##   # #     # #   # # # # #  #     #  ## #   #  #  #
## #   #  ### # #  #   # #   # #  #    ## # ##   ##  #  ####  # # # #      # # # # ##      #  #  # #
#  # #   #   #  # # ## #  ## # # ## ##    #   ## #  ## ##    # # ##  # # # #  #  #   ## ### #  # # #
# # # # #  #  #   #  # ##  #   ##   # # #  # # #  ##   #  ###       #  #  # #  #  # #  #    ## #  ##
#      #  # #  ##  # #  ##  # # # ##   ### # # # #   ##  ##   #### # ## #   # #  #    ## ##   ###  #
## # ##  #    #  # #  #  # # #    #  #  ## # #   # ##   #   ##    #     ## #  # #  ###   # ##  # # #
#  #  # # # #   ##   # # # #   # ## ###      ###   ### #  ## # ##   # #     #  #  #    ##    #     #
# #  #  #  #  ##   ###   #   ###   #### ### #   ### #   # #    # ###  # ###  # ## # ###   # #  # # #
##  #  # #  #    ##    #### #   ## ###    ##  # #    # ## # # ## # # ###   ###    #   # #  #  ###  #
#  #  #   #  # #  # ###  #  # #  #  #  # #   #  # ##       #       #  #  #    # # ###  ###   # #  ##
# # # # # # # # ##  # ## # #  # # #  # ##  ##  ### ##### #  # # #####   # ###    #   #  # # #   # ##
#   #   # #      # ##  #   ###  # ##  #   # # ###       # #  ###   #  ##     # ##  #  #    ## # #  #
# # ## #  # # ## #   #  ##   # #    #   #   #  #  #####   ##  #  # # # # ### #  # ### # ## #  #  # #
# #   #  ##  #    ## ##    #   # ## # # # # # ## #     ##   #   #  #   #   #  ##   #   ##  # ###  ##
# ###  # #  #  ### #  ### # # #  ##  #   #  # #   # # #  ## ## # #  # # ##  # #  ##  #    #   # # ##
#    # # # ## #     #    #   #  #   #  #  ###   # # # # # #  # #   # #    # #  #   ## ## #  ##  #  #
# # #  # # #  # ## #####   #   ## #  ## ##   # #  # #      # ##  ##    ## #  #  ## #    #  #   # # #
#  #  #  # # #  #   #   # # ###   # #    # #  #  #  ## # # #   #   # ## #   # # #  # ##  #   #   # #
# #  ## #  #  # # #  ##  #     # # #  ##   ##  # # #   #  # ##  ##   #   ###  #  # #   #  ##  # ## #
# # #    #  #   #  # ###  ## #     # #  ###  # #  #  ##  #  # #   ### # ##   #  #    ### #  #  #   #
# # # ###  # # # # #  # #  #  #### #   ##   #  ##  # #  #  #   ##   #   #  ##  ## # #    # #  #  # #
# # #    #   ### #  #    #  # #   # ##    ##  # ##   # ### # # # ## # #   #   #    #  ##   # #  #  #
# #  ### # ##     # #### # #  # #   #  # #   ##   ####  ##   #   #  ## # ## # # ###  ## # #   # # ##
#  # #   ##   # # #    #    # #  # #  # #  ##   #     #   # #  # # #     #  ##  # # #   ##  # # #  #
## #   ##   ## ## # ##  # # #  # #   #  # #   ## ## #  ##  #  #  # # ####  #   #  #   ##   # ##  # #
##  ### ## ##     # #  ##  # #   ####  #  ## ##    # #   # ###  #  #    # ### # #  ##  # ##     #  #
# # #      #  ####   # # # #  ###     #  #      # #   # ##     ### # ## # ##  # # # # ## # ## # # ##
#   # ## ### #    ## # # # # #    ### # # # ## ##   # #   ## #  #  # #  #   #       #    #  #  #  ##
## #  #  #   # ##  # # # # # # # #   ##    #  #  ####  ##   ## #  #   #  ##  ## # #  ######  #  #  #
#  # ## # # ## # #   # #   #   ##  #   ###  #   #     #  ##     #  # ###  ##  ## #  ##   ## ## # # #
# #  #  #   #  #  ####  # # ##    # # #  # # # ## ######   ####  # #  # #  ##     #    #    #  #   #
# # ## # ##  #  # #   # # #    ###      #  #   #  #   #  #     ##  ## #  #  ##### ###### ## # #  # #
#  ##  #   # # ##   # # #  ### #   ### #  #  ### #  # # #  ###  # # # ## ##     #       #   #  ##  #
##    # ##   #    # ##   #    #  ##     #  #       ## # # #   # # #    #   ## #  ###### # ## #   ###
##### #    ## ###  #   ## ###   #  # ## # #  ##### #  #  #  #   # #### ## #    # #    # # #   ##   #
##   #  # #      # # ##      ### #   # ##  ##     #  ###  #  ####    #  #  ## ###  ##   # # #   ## #
#  # # ### # # #   #  # ## # #    # ##   #    ### # # # #  #     ###  #  #  #  #  ## ###    # #  # #
# # #   #   #   ##### # #S#  # ##     # # # ##    # #   # # ####    #  #  #  #   #      ####   ### #
#   # ##  # ####   ## #   ## #   ####      #   # ## # #     #   ## ###  #  #  ###  # ##     # #    #
### #    ##      #    # ##   # ##   # ### #  ## #   ## ## #   #  #  ## # # # #   #  #  ####  #  ## #
#    ####  ### #### #  ##  ##   # #  #  # # # #   ##     #  ## ##  #   # # #   #  #  #    ##  #  # #
# # #     #   #  ##  ##   ### # #  #  #   # # # ##   ### # #      #  ##  #  # # #  #  # ##   # # # #
#  #  # #   #  #   #  # ## #  ##  ## #####  # # #  ##  # ##  #####  # # ### #    ## # # #  ### #  ##
# #  ##  # # #  ## # #  #  # # # #    #    #      #   ##    #      #     ##  # #      # # #     #  #
#   #  #  #   #    #  # # ##   #  # ##  ###  ## ## # #  ###  # #### # ##   #  #  #### #   ## ##   ##
# ##  # # # #  # # ## # #   ## ## #    #   #   #   #  #     #  #    # # ##  # # #     # ## #   ## ##
# #  #  #    # # ##   # # #     #  ## #  #  ## # #  #  # ## # ### ##  #   # #  ## ####  #    #  #  #
#  # # # ### # #  # # #  #  # #  # #  # ### #  #  #  #     ##  #     #  # #  #    #  # #  ### #  # #
## #        #  # #   # #  ##   ###  ###  #  ## # # # # ####   #  ## # ### # # #### # #  #   #  # # #
#  # ######  # #  # #   #   # #   #    #  #   ##   #  #     ## # # #      #   #       # ## #  ## # #
# #       ## #  # #   #  ##  #  #  # #   # ##   ## ##  # ###        # # #  # ## # # ###  #   ##  # #
# ### # #  #  #  # ### # # # ##  #  #  ###   ##     # ##   #### # # ###  # # #  ###    # # ##   #  #
#    ##  #  #  #   #   #   #    # # # #    #  # # # #   ##     # #     # # #   #   ## ##  #   ##  ##
## #   #  # ##  ##   #  ##  # ##  # # # # ###  # ### ## #  ### #  #### # #  #### #    # #   ##  #  #
# # ##  #  #   ## # #  #   # # # #  #  #  ## ##   #     # #    ##    #   # #      ### #  ###   # # #
#     #  ##  #    #  # # ###     # ## ## #      # # #####  # ##  # ## # #  # ### #      #    #   # #
## ##  #    # ### ## # #    # ## # #     # ## ##  # #    # #  ##   #    # #  # ##  # ## # # # ###  #
#    #  # ##  #    # # #### # # #  # ####  # # ##   ## #    #  ###   ###  # #     # #  #  # #    # #
# # # #  #   #  ## #  #   # #   # # ##    #      # #   ## #  #   # ##   # # # ####    #  ##  # # # #
# #    # ## #  # #  #   # #  # ##      # # ## ##  # ##   #  # ##  #   #  #  # #  # # #  #  #   #   #
#  ## #   # # #   ## # ## # #  #  #######    ## #     ###  #    # # ## #   #  ##   # # #  # ### ## #
##  # # #   #  ##    ##   #  #  ##     #  ##     # ##    # # ##   #  #  ### #  # ##  #   #  # #   ##
### #  # ### # #  # #   ### # #    # # # #  # # #  ##### # #  ###  # ##   # ##  ##  # ## # #    #  #
###  # #       # ## # ##    # ## ## #  #  #   # # # #  #  #  #   # #   ##     #    #     #   # # # #
##  ##  # ##### ##  # ## ###      #   # #  ###  # #   # # # #  #  #  # ## # # ## #  # # # ####   # #
#  #  #   #        ##    # # #### # ##    #   #   # #     #   # #  # #   # #    #  #   #      ###  #
##  #  ###  ## ###   ####   ##    #   # #   #  # #   # ###  ##   #  #  #    ###   ## ##  ## #     ##
# #  #    ##   #  # #   # #    ### ##  # #### # #  # ##  # #   ##  #  # ###    # #   #  #  ## # ## #
#   #  ##  # ## # #  ##   ## ##  #   # #      #  # #   #     # #  #  #     ### # # ##  ###     #   #
# # # ## #    #    # #  ##   #  #  #     #######  # ##  # ###  # # #  # # #  #  ##   #  #  ####  # #
##  ##    # #  # ##  # # # ##  #  #  ### #    # #    ##  #   # # # ## ##   #  #   # # # # #     #  #
#  # # ## #  # #    #    #  ##   # ##   #  ##   # ##    #  #   # #       #   #  # # # #  #  ## #  ##
##      #  # # # # #  ## ##  ####     #  # #  ##  # # ### # # #   ###### # ##  # #     # # ##  # # #
# # ####  # #  ##  # # #  ##    # #### #  #  # # #   #   #   #  # #    #  #   #   ## # #   #  ##   #
#  #     #    #   # #   #   # # # #     #  #   #   #   #   #  ###   ##  ##  # # #  ##  ####  #   # #
# #  ####  ### # #   ##   #  ##     # ## # # ## ### ### # # #    ## # #   #  #   #    #    #  # #  #
# # #     #    #   #  # #  #   ####  #     #    #        #   ### #     ##  #   ## ##### ##  ### # ##
# # ## ## # ##  # # # #  ## # #    # # ## #  # #  # # ## # #   #  ## ###  ## ##   #     # # #   #  #
#      # #    #  ##    ##   ### ## ### # ## ##   #  #  ##   ##  # # #    ##    # #  ## #  # # ## # #
# # # #    ##  #    ##    #     #      #      # #  ###    #   #       # #   ##     #    #     #    #
####################################################################################################