########################################################################################################################
#             # #             #       #  # # # #    # # # # ## # # # # # # #     #       #   #         #              E#
# ### ####### # # ### ####### # # ### ##         # #                         ### # # ### # # # ####### # ### #### #### #
# # # #         # # # #     # # # # #  # ### ##### # ####### ################# # # # # # # # # #     # # # #     #   # #
# # # ########### # # # ### # ### # # #  # # #     # #     # #                 # ### # # # ### ### # # # # ##### # ### #
# # #             # # # #   #     #   ##   # ####### # ### # ############ ## # #     #   #         # # # #     # #     #
# #  ########### #  # # # ## #####  ##   # #         # # # #             #   #  # ###  ## ######### #  # # # # # # #####
# # #           # # # # # #       # #  ## # ##### #### # # #### # ###### # # # # #   # #             # # # # # # # #   #
# # ###### # ##     # # ### ### ###  # #         #     #       # #     # # # #     # # # ## ##### ## # # ### # # # ### #
# #       #    #### # #     # #     #  ####### # # #### # #### #   ### # ##   # # #  # #   #     # # #       # # #     #
# # # ###  # ##     # # # # # ########         # # #     #   # # # # # #   # # # # # # # # # ###   # #### ### #  ## ## #
# # # # # #   # ### # ## #  #       # #########  # # ### # ### ### #   # # # #       # # # #   # # #     #     #   # # #
# ### #   ####  #   #     # # #####             #  # # # #         # # # # # # ######  ### # # #  # #### # # # # # # # #
#     # #     # #### #### # # #    #############  #  # # #### # ### #  # # # # #     #     # # # #     # # # # # # #   #
###### # #### #         # # # # # #             #  # # #     # #     # # # # # # #### ##### ## # # ### # # ##  ### # ###
#           # # ### ##### # # # # # ########### # #  # ##### #   ### # # # # #   #             # # # # # #   #     # # #
# ### ##### # #   # #     # # # # # #         # #  # #     # # # # # # # # # ####  ### ########  # # # # # #  #####  # #
# # #     # # # # # # ####  # # # # #### ## ###  # # # ### # ### # # # # # #     #   #         # # # # # # # #     #   #
# # ##### # # #  #  # #   # # ### #     # #     #  # # # # #     # # # # # # ### # ## # ###### # # # # # ###  # ## ### #
# #     # # # # #  #  # # # #      #### # # #### # # # # # ####### # # # # # # # #     #     # # # # # #     #  #    # #
# # ### # ### #  #  # # # #  # # #    # # # #      # #   #         # # # # # # # ##### # ### # ### # # #### # # #####  #
# # # # #     #### #  # ### # # # ##### # # ### ## # #### #### ##### # ### #   #     # # # # #       #     #         # #
# # # #  #####     ## #                 #       #  #        S# #     #     # #  #### # # # #  # # ### # ## # ####### # #
# # # # #      ###  # ############ # # #  ###### #  ########## # #### ### # # #    # # #   # # # #     #   # #     # # #
# # # #  # ### # # ##             ##  # ###        #           # #       #     ##### #  ####     # ### ### # # ##### # #
# # # # #  # # #     # # # # # ## #  #     # ######  ##### ####  ### ### # # #       # #     # # # #       #   #     # #
# # # #  # # #  ##### # # # #   #  # # ### # #     # #   #     #     # # # ## ###### # # ## # ## # ######## ## # ### # #
# #   # #  # # #             #### #  # # # # ##### # ###  # ##  ###### # #         # # # # #     #             # #   # #
#  ## #  # # # # ########### #    #### # # #     #       #   # #       # # ####### # # # # # #### ##### # ### ##  #### #
# #   # #  # # # #         # # # #     # #  #### ######## #### # ### # # #       # # # # # # #         #  #  #   #     #
#  ####  # # # # ##### ### # # # # ##### # #                   # # # # #  ######## # # # # # # #######  # ## # # # #####
# #     ##   # #     # # # # # ### #     #  #################### # # ### #         # # # # # # #     # #     # # # #   #
# # ### # ## #  #### # # # # #     # ##### #                     # #     # ## # #### # # # # # ##### # ####### # # # # #
# # # # #  # # #   # # #   # # # # # #     # ########## #########  #### #  #   #     # # # # #     #           # # # # #
# # # # ## # # # ##  # # ##  ## #  # # ### # #         #         #     # # ####  ##### # # # ##### # ###### ###  # # # #
# # # #    # #     # # #   #     #   # # # # # ####### # #### ## # ###         # #     # # #     # # #     #   # # # # #
# # # #### #  #### # # #### ####  #### # # # # #     # # #   # # # # ## # # ## # # ##### # ##### # ### ### # # # # # # #
# # #      # #   # # #         # #     # # # # # # # # # ## #    # #   # # # # # # #     #     # #       # # # # # # # #
# # ########  # ## # #### ## # # # ## #    # # # # # # #    # ## # # #       # # # # ## #  # ###  ######## # ### # # ###
# #          #  #  #     #   # # #  ## ##### # # # # #  # # #  # # # ##### # # # # #   # # #     #         #     # #   #
# # ######### # # # #### # # ### # #         # # # ### # # ## #  # #     # # # # # # # # #  #####  ## ##### ###### # # #
# #             #      # # #       # ## # # #  # #            #### ####### # # # # # # # # #     #   #             # # #
# ############### ### #  ## ######## # # # # # ## ############             # # ### ### # # ##### # ### ############ ## #
#                 #    #             #                         # ## # # # #  #         #         #                     #
########################################################################################################################
